211111111111111111111111111111111111111111111111111111111112
100000000000000000000000000000000000000000000000000000000001
100000000000000000000000000000000000000000000000000000000001
100000000011111111111111111111111111111111111111100000000001
100000000010000000000000000000000000000000000000000000000001
100000000010000000000000000000000000000000000000000000000001
100000000010000000000000000000000000000000000000000000000001
100000000010000000000000000000000000000000000000000000000001
100000000010000000000000000000000000000000000000000000000001
100000000010000000000000000000000000000000000000000000000001
100000000010000000000000000000000000000000000000000000000001
100000000010000000000000000000000000000000000000000000000001
100000000010000000000000000000000000000000000000000000000001
100000000010000000000000000000000000000000000000000000000001
100000000010000000000000000000000000000000000000000000000001
100000000010000000000000000000000000000000000000000000000001
100000000010000000000000000000000000000000000000000000000001
100000000010000000000000000000000000000000000000000000000001
100000000010000000000000000000000000000000000000000000000001
100000000011111111111111111111111111111111111111100000000001
100000000000000000000000000000000000000000000000000000000001
100000000000000000000000000000000000000000000000000000000001
100000000000000000000000000000000000000000000000000000000001
100000000000000000000000000000000000000000000000000000000001
100000000000000000000000000000000000000000000000000000000001
100000000000000000000000000000000000000000000000000000000001
100000000000000000000000000000000000000000000000000000000001
100000000000000000000000000033300000000000000000000000000001
100000000000000000000000000000000000000000000000000000000001
211111111111111111111111111111111111111111111111111111111112
