211111111111111111111111111111111111111111111111111111111112
100000000000000000000000000000000000000000000000000000000001
100000000000000000000000000000000000000000000000000000000001
100000000000000000000000000000000000000000000000000000000001
100000000000000000000000000000000000000000000000000000000001
100000000000000000000000000000000000000000000000000000000001
100000000001111111111111111111111111111111111111000000000001
100000000001000000000000000000000000000000000001000000000001
100000000001000000000000000000000000000000000001000000000001
100000000001000000000000000000000000000000000001000000000001
100000000001111111111111111111111111111000000001000000000001
100000000001000000000000000000000000000000000001000000000001
100000000001000000000000000000000000000000000001000000000001
100000000001000000000000000000000000000000000001000000000001
100000000001000000011111111111111111111111111111000000000001
100000000001000000000000000000000000000000000001000000000001
100000000001000000000000000000000000000000000001000000000001
100000000001000000000000000000000000000000000001000000000001
100000000001111111111111111111111111111000000001000000000001
100000000001000000000000000000000000000000000001000000000001
100000000001000000000000000000000000000000000001000000000001
100000000001000000000000000000000000000000000001000000000001
100000000001111111111110000000000000111111111111000000000001
100000000000000000000000000000000000000000000000000000000001
100000000000000000000000000000000000000000000000000000000001
100000000000000000000000000000000000000000000000000000000001
100000000000000000000000000000000000000000000000000000000001
100000000000000000000000000033300000000000000000000000000001
100000000000000000000000000000000000000000000000000000000001
211111111111111111111111111111111111111111111111111111111112
