211111111111111111111111111111111111111111111111111111111112
100000000000000000000000000000000000000000000000000000000001
100000000000000000000000000000000000000000000000000000000001
100000000001000000010000000000010000000010000001000000000001
100000000001000000010000000000010000000010000001000000000001
100000000001000000010000000000010000000010000001000000000001
100000000001000000010000000000010000000010000001000000000001
100000000001000000010000000000010000000010000001000000000001
100000000001000000010000000000010000000010000001000000000001
100000000001000000010000000000010000000010000001000000000001
100000000001000000010000000000010000000010000001000000000001
100000000001000000010000000000010000000010000001000000000001
100000000001000000000000000000010000000000000001000000000001
100000000001000000000000000000010000000000000001000000000001
100000000001000000010000000000010000000010000001000000000001
100000000001000000010000000000010000000010000001000000000001
100000000001000000010000000000010000000010000001000000000001
100000000001000000010000000000010000000010000001000000000001
100000000001000000010000000000010000000010000001000000000001
100000000001000000010000000000010000000010000001000000000001
100000000001000000010000000000010000000010000001000000000001
100000000001000000010000000000010000000010000001000000000001
100000000001000000010000000000010000000010000001000000000001
100000000001000000010000000000010000000010000001000000000001
100000000001000000010000000000010000000010000001000000000001
100000000001000000010000000000010000000010000001000000000001
100000000000000000000000000000000000000000000000000000000001
100000000000000000000000000033300000000000000000000000000001
100000000000000000000000000000000000000000000000000000000001
211111111111111111111111111111111111111111111111111111111112
